%%%%%%%%%%%%%%%%%%%%
%.   %        %  . %
% %% % %%%%%% % %% %
% %              % %
% % %% %%  %% %% % %
%  .   % .  %      %
% % %% %%%%%% %% % %
% %             .% %
% %% % %%%%%% % %% %
%.   %   P  . %    %
%%%%%%%%%%%%%%%%%%%%
