%%%%%%%%%%%%%%%%%%%%
%    %        %  . %
% %% % %%%%%% % %% %
% %              % %
% % %% %%  %% %% % %
%      %    %      %
% % %% %%%%%% %% % %
% %              % %
% %% % %%%%%% % %% %
%    %   P    %    %
%%%%%%%%%%%%%%%%%%%%
