%%%%%%%%%%%%%%%%%%%%
%    %        %   .%
% %% % %%%%%% % %% %
% %              % %
% % %% %%  %% %% % %
%      %    %      %
% % %% %%%%%% %% % %
% %  .           % %
% %% % %%%%%% % %% %
%    %   P   .%   .%
%%%%%%%%%%%%%%%%%%%%
