%%%%%%%%%%%%%%%%%%%%
%    %        %    %
% %% % %%%%%% % %% %
% %              % %
% % %% %%  %% %% % %
%      % .  %      %
% % %% %%%%%% %% % %
% %              % %
% %% % %%%%%% % %% %
%    %   P    %    %
%%%%%%%%%%%%%%%%%%%%
